{"levels": {
  "name": "custom",
  "total": 1,
  "level-001": [
    "& #0000#    $    $          ",
    "###----#H########## #####   ",
    "  #    #H#    -       -  -  ",
    "  $    #H#H### ####$## ## ##",
    "###    #H#H#$# #####$## ## #",
    "HH     #H#H# #     ##$## ## ",
    "HH     HH#H###      ##$## ##",
    "HH        H#         ##$## #",
    "###    ###H#          ##$## ",
    "@@@@@@@@@@## #######H  ##$##",
    "             #$H#   H   ## #",
    "$         #H #  #   H       ",
    "#########H####@@########H##H",
    "         H          #    # H",
    "$        H    H#H  $#####$ H",
    "##########################H#"
  ]
} }