{
  "levels": {
    "name": "/home/az/src/Infinner/src/jvmMain/temp/bug.raw",
    "total": 232,
    "GHOST BLOCK": [
      "$                        $",
      "H                        H",
      "H                        H",
      "H                        H",
      "H                        H",
      "H                        H",
      "H                        H",
      "H                        H",
      "H                        H",
      "H          0             H",
      "H                        H",
      "H                        H",
      "H            &           H",
      "H          H H           H",
      "H           #            H",
      "##########################"
    ],
    "GARBAGE OF GUARD": [
      "S00  &                    ",
      "S########################$",
      "S########################S",
      "S########################S",
      "S########################S",
      "S########################S",
      "S########################S",
      "S########################S",
      "S########################S",
      "S########################S",
      "S########################S",
      "S########################S",
      "S------------------------S",
      "S########################S",
      "S########################S",
      "SSSSSSSSSSSSSSSSSSSSSSSSSS"
    ],
    "level-3": [
      "X @##                     ",
      "                          ",
      "                          ",
      "                          ",
      "                          ",
      "                          ",
      "                          ",
      "                          ",
      "                          ",
      "                          ",
      "                    0     ",
      "                    X     ",
      "                    X     ",
      "                    X     ",
      "                    X     ",
      "                   &X     "
    ],
    "level-4": [
      "###                       ",
      "                          ",
      "                          ",
      "                          ",
      "                          ",
      "                          ",
      "                          ",
      "                          ",
      "                          ",
      "                          ",
      "                          ",
      "                          ",
      "                          ",
      "                          ",
      "                          ",
      "                          "
    ],
    "level-5": [
      "                          ",
      "                          ",
      "                          ",
      "                          ",
      "                          ",
      "                          ",
      "                          ",
      "                          ",
      "                          ",
      "                          ",
      "                          ",
      "                          ",
      "                          ",
      "                          ",
      "                          ",
      "                          "
    ]
  }}