{
  "levels": {
    "name": "hir_rcnt",
    "total": 19,
    "MACRO CHECKER": [
      "  HH  HH  HH  HH  HH  ##  ",
      "  HH0$HH $HH $HH $HH&$##  ",
      "    HH  HH  HH  HH  ##    ",
      "   $HH $HH $HH $HH $## $  ",
      "  HH  HH  HH  HH  ##  ##  ",
      "  HH $HH $HH $HH $## $##  ",
      "    HH  HH  @@  ##  ##    ",
      "   $HH $HH $@@ $## $## $  ",
      "  HH  HH  ##  ##  ##  ##  ",
      "  HH $HH $##0$## $## $##  ",
      "    HH  ##  ##  ##  ##    ",
      "   $HH $## $## $## $## $  ",
      "  HH  ##  ##  ##  ##  ##  ",
      "  HH $## $## $## $## $##  ",
      " H----------------------# ",
      "                          "
    ],
    "GIVE AND TAKE": [
      "     $     S              ",
      "#####H   &H#              ",
      "#  ##H---H##H#######H#####",
      "#$0##    H$# H#$#$#$S# $#H",
      "######--H####HH##########H",
      "#$##$#  H# $#HSH$ #$ ##$#H",
      "###  $-H#####H #H########H",
      "# H#X# H  ##$H#$HH#$H#0$#H",
      "#$0#   H-####H##HSH######H",
      "#### H-H #$##H  ##SH $$ #H",
      "#$#H0H   ###$#H##$#SH @@@H",
      "#####H##H#####H ###HSS   H",
      "     S$#H#$#  H  $#H #####",
      "H########H####H####H ###$#",
      "H   $#H$#H#$#$S$##$H ###H#",
      "###S##H###########XH $#@@@"
    ],
    "LIGHTNING BOLT": [
      "          &           0   ",
      "###############SSS########",
      "############$#SSS#########",
      "#############SSS##########",
      "############SSS###########",
      "###########SSS############",
      "##########SSS#$###########",
      "#########SSS##############",
      "########SSSSSSSSSS########",
      "##############SSS#########",
      "#############SSS##########",
      "############SSS###########",
      "###########SSS############",
      "##########SSS#$###########",
      "#########SSS##############",
      "########SSS###############"
    ],
    "REPTILE": [
      "                          ",
      " HHHH HHHH  HHHH  HHHH    ",
      " HHHH  HH #@ HH ## HH ##  ",
      "H HH ##  ##@@  @@@#  @### ",
      "HH  X### @#$@& ##$#  ##$# ",
      "$H  ##$#  #@ HH ## @@ ## #",
      "H HH ## ##  HHHH  @@@@  ##",
      " HHHH  X#X# HH$H  @@0@  ##",
      " HH$H  ##$#  HH ## @@ #X #",
      "# HH HH #X ##  ####  ##X# ",
      "##  HHHH  ##@@ ##0#  ##$# ",
      "0#  HH$H0 @#$@  ## ## #X H",
      "# ## HH HH @# HH  ####  HH",
      " ####  HHHH  HHHH ##$#  HH",
      " ##$#  HH$H  HH$H  ## ## H",
      "  ##    HH    HH SS  #### "
    ],
    "QUARTER CHALLENGE": [
      "    &          S#   0     ",
      "##########  $ $H####@@@@@H",
      "#H$#H$#H$#S####H####   $#H",
      "##########S   $ $ #H#####H",
      "#$H#$H#$H######S###H#####H",
      "###########$  $H###H#####H",
      "#H$#H$#H$#H####H###H#####H",
      "##########H$   S###H###$#H",
      "        $ S####H@@@@@@@@@H",
      " $  0     S$ $#H    0   #H",
      "###H#H#H#S##S###H#H######H",
      "#H#H###H#H# S   H##H #H##H",
      "#H#$#$###H#H###### $##$##H",
      "#$#H#H#$###H     #H##H## H",
      "#H#H#H#H#$######H###H#$H#H",
      "#H#####H#H      H#$#$H##H#"
    ],
    "CROSSOVER POINT": [
      "                         S",
      "                         S",
      "                         S",
      "           $$$$          S",
      "  S####    HHHH   S####  S",
      "0S######0 HHHHHH0S######&S",
      "H########HHHHHHHH########H",
      "HH#    ##XH    HHH#    ##X",
      "HHH$$$$HX##S   #HHH$$$$H##",
      "#HHHHHHHH########HHHHHHHH#",
      "  HHHHHH  ######  HHHHHH  ",
      "   HHHH    ####    HHHH   ",
      "                          ",
      "                          ",
      "                          ",
      "                          "
    ],
    "ARKANOID": [
      "            &             ",
      "SSSSSSSSSSS000 SSSSSSSSSSS",
      "##### #####X0XX####S######",
      "##### #####X XX####S######",
      "##### #####X XX####S######",
      "     - - -      S SSS     ",
      "      - - -    S S S      ",
      "       - - -  S S S       ",
      "        - - $$ S S        ",
      "         - $$$$ S         ",
      "           $$$$  S        ",
      "       H    $$    H       ",
      "      @H####XX####H@      ",
      "      @H##########H@      ",
      "      @H##########H@      ",
      "       H          H       "
    ],
    "SANDRA": [
      "                  S  S  S ",
      "   H------ --     S  S  S ",
      "   H    - #- #  # S  S  S ",
      "   H     ## ## ## S  S  S ",
      "   H     ########  S S S  ",
      "   H    ##########  SSS   ",
      "   H    ##$S#$S###   S    ",
      "   H    ##  #  ###   S    ",
      "   H    ##X###X###   S    ",
      "   H     #X###X##   #S    ",
      "   H      X###X -  ##S    ",
      "   H   & #######  ###S    ",
      "   H   ###########X# S    ",
      "   H  ############X  S    ",
      "   H #############   S    ",
      "  0H ## #########    S0   "
    ],
    "CHROMOSOME": [
      "##                        ",
      "##$-----##H-H##     ######",
      "###     ##H  ### $########",
      " ##0    ##H   ##$####     ",
      " ###   ###H  0$##X#$      ",
      "  ##   ## S H####X##H     ",
      "  ###$### H##### X######H ",
      "   ####   H###      ####H ",
      "   ####   H             H ",
      "  ####    H&      ##    H0",
      "  ###   H####  #####H## H#",
      " ####   H########## H##H##",
      " ## ##$ H   $###$   H##H##",
      "### ###  H#######   H ### ",
      "##  ###  H### ######H#####",
      "##  ### ###H0  $####H##$##"
    ],
    "BEAST NUMBER": [
      "-$      ---  &   ----     ",
      "$$H@@@@@$$$H#####$$$S#####",
      "$H######  H######  S######",
      "H###     H###     S###    ",
      "H##   -- H##   -- S##     ",
      "H#####   H#####   S#####  ",
      "H######  S######  S###### ",
      "H## H### S## -### S##H ###",
      "H##  H## S##  H## S##H  ##",
      "H##$ H## S##$ H## S##$  ##",
      "H###  ## S###  ## S###  ##",
      "H @@@@@@ S ###### S ######",
      "H  ####  S  ####  S  #### ",
      "H   0    S   0    S   0   ",
      "##########################",
      "##########################"
    ],
    "BEST CHOICE": [
      "&    0      0      $      ",
      "H#####$#####H$H###$#####$H",
      "##$$$#$$$#$#H$H#$###H#$  H",
      "##H H# #####H H##$0#H### H",
      "###### H#$#$H H## ##H $# #",
      "#$ $#$ ####@H H###########",
      "# $H## #   #H H   H#      ",
      "###### # $ #H H#####H@### ",
      "##H  # #   #H H ### H# $  ",
      "$#  $# #####H H#####H####H",
      "##@@@# #$##$H H##$##H $ #H",
      "     # #H###H   ###  ####H",
      "$####  $##$#H H#$$$#H# $ H",
      "H# H#$ #####H H#####H####H",
      "######      H H#####H $ #H",
      "#$$$H# H####H # $$$ H####H"
    ],
    "PERMISSION DENIED": [
      "S                         ",
      "S       $###              ",
      "# ####H#####H #X###H######",
      "# ####H#####H## ## HH# H#$",
      "# ###HH     H#  X$ #H#  # ",
      "#$S#HH# ####H -### #H  ##H",
      "####H##H#0$#@@ $ $ HH# #0#",
      "$   HH# ### $ $#  #H #####",
      "@@H##H  ##   #   #@H&     ",
      "@@H####@$@#H# #X###H#####H",
      "  SH       H#      H#$#$#H",
      "H## H#############H######H",
      "##$#H@0#$##$$H#$# HH#####H",
      "####H####### #$### H$###$H",
      "0## H              H #####",
      "#####H############H###0###"
    ],
    "JACK POT": [
      " S                        ",
      "$S    $     $     $     $ ",
      "#H    #H    #H    #H    #H",
      "$H     H     H     H     H",
      " H     H     H     H     H",
      " H     H     H     H     H",
      " H     H     H     H     H",
      " H #S# H #S# H #S# H #S# H",
      " H ### H ### H ### H ### H",
      " H     H     H     H     H",
      " H     H     H     H     H",
      " H     H     H     H     H",
      " H$    H$    H$    H$    H",
      " H#    H#    H#    H#    H",
      "00          0 &        00H",
      "##########################"
    ],
    "KING GHIDORA": [
      "       $0   $0            ",
      "       H##  H##      $0   ",
      "       H### H###   HHH##  ",
      "       H#   H#   HH###### ",
      "       H##  H#  H###      ",
      "HH     HH## H#  H#      HH",
      "HHHH    HH##H# H##    HHHH",
      "HHHHHH   HH#H#H##   HHHHHH",
      "HHHHHHHH  H#####  HHHHHHHH",
      "HHHHHHHHH########HHHHHHHHH",
      "HHHHHHHHH########HHHHHHHHH",
      "HHHHHHHHH########HHHHHHHHH",
      "HHHHHHHH ######## HHHHHHHH",
      "HHHHHH   ########   HHHHHH",
      "HHHH     ########     HHHH",
      "HH   &    ######    0   HH"
    ],
    "MECHANICAL KING GHIDORA": [
      "       $0   $0            ",
      "       H##  HHH      $0   ",
      "       H### HHHH   HHH##  ",
      "       H#   HH   HH###### ",
      "       H##  HH  H###      ",
      "HH     HH## HH  H#      HH",
      "HHHH    HH##HH H##    HHHH",
      "HHHHHH   HH#HHH##   HHHHHH",
      "HHHHHHHH  H#HH##  HHHHHHHH",
      "HHHHHHHHH###HH###HHHHHHHHH",
      "HHHHHHHHH#HHHHHH#HHHHHHHHH",
      "HHHHHHHHH#HH$$HH#HHHHHHHHH",
      "HHHHHHHH ######## HHHHHHHH",
      "HHHHHH   ########   HHHHHH",
      "HHHH     ########     HHHH",
      "HH   &    ######    0   HH"
    ],
    "MISSING LINK": [
      "  S                     S ",
      "  S                     S ",
      " 0S       &     0       S0",
      "  H###$$$###$$$###$$$###H ",
      "  H# #S### ##### ##### #H ",
      "  H###   ###   ###   ###H ",
      "  H                     H ",
      "  H###$$$###$$$###$$$###H ",
      "  H# ##### ##### ###S# #H ",
      "  H###   ###   ###   ###H ",
      "  H                     H ",
      "  H###$$$###$$$###$$$###H ",
      "  H# ##### ##S## ##### #H ",
      "  H###   ###   ###   ###H ",
      "  H---------------------H ",
      "  S                     S "
    ],
    "BALANCE IN THE MAZE": [
      "              S           ",
      "@#@#@#@## ####S# @#@#@#@#@",
      "         0  $$S#0         ",
      "H##H H##H #H#### ##S#####H",
      "H# #####H  H##   ###$#$##H",
      "H# # $ #H ####H# $ ####$#H",
      "H# ## ### #   H# ##H#$$##H",
      "H# ##H#$  #H#### $#  @#  H",
      "H# $#H# #0#H   #0####@###H",
      "H# # H### ####H# ####@@@@H",
      "H#######$ #   H# ####$ $@H",
      "H         #H#### ##### H@H",
      "H#######H  H      -##    H",
      "H#$H#$###S#H  H#S# ##H###H",
      "H########S#H  H#S#   H###H",
      " #H  $#  S#H&0H#S# H##$#$H"
    ],
    "DELICATE FLOOR": [
      "S        &  #############S",
      "S       ####### $        S",
      "  #$###H#$#H$#$######H#SX#",
      "S####$#H#H######  ###H    ",
      "S     #H###### #### #####H",
      "#######H------S#$##      H",
      "##$H#$#       S####H#### #",
      "##############S    H  H###",
      "        ##0##  H######H#$#",
      " ##H###########H ##$  H ##",
      "## H#$  -      H -## H    ",
      "$##H # H #######0 ###H ###",
      "## H##  #H $#H$######H ###",
      "$  H###H#   #  ###$# H ###",
      " H# #$ H  ###########H -  ",
      "  #H # ####0###      H  #0"
    ],
    "THE SHELTER": [
      "         &      0         ",
      "H#####H####H######H#######",
      "H#$ #$S#$H#$ #$H#$S#$H#$ #",
      "H#########################",
      "S                         ",
      "#############H####H## #0#S",
      "H#---------$@H#00#S  H###H",
      "H#--------$@@H###H#######H",
      "H#-------$@@@H# $ # $ ###H",
      "H@@@@@@@@@@@@############H",
      "H                        H",
      "##H###########H#####H##H##",
      " #S$H ##$# ##$# #$H#S# $# ",
      " ####S#### #### ####S#### ",
      "     S              S     ",
      "##########################"
    ]
  }}