{
  "levels": {
    "name": "msx",
    "total": 13,
    "CASTLE PANIC": [
      " #  0                0  # ",
      "S##@S  @@@@@@@@@@@@  S@##S",
      "S   @S$$$       $$$$S@   S",
      "###H@@@@@SSSSSS@@@@@@@H###",
      "#$#H-    -- - --     -H#$#",
      "###H&####- # # -#####0H###",
      "###H $#$# ##$## #$ #$ H###",
      "$##H  ### ##### ####  H##$",
      "###H  ##   ###    ##  H###",
      "### H ## ######## ## H ###",
      "#$#H  H  #  $$  #  H  H#$#",
      "### HH #X#  ##  #X# HH ###",
      "      H#  $####$  #H      ",
      "######H   ######   H######",
      "#     HX##########XH     #",
      "######H############H######"
    ],
    "FRUITS OF PASSION": [
      "S  #        $##$      $# $",
      "S#H #H-----H#  #H----H# H#",
      "S# H#   H   #$$#   H  #H #",
      "S# H #  H  # HH #  H  #H# ",
      "S#  H#  H  # HH #  H  #H# ",
      "S#  H#0 H 0# HH #0 H &#H $",
      "S  $H # H # H  H # H # H #",
      "#H $ H# H # H  H # H #H  #",
      "#H   H# H # H  H # H  H  #",
      "#$H  H #H# H    H #H#H  # ",
      " #H  H #H# H    H #H#H  # ",
      " #H  H# H #H    H# H #H # ",
      " #$  H# H # H  H # H #H # ",
      "  #HH#  H  #$HH$#  H  ##  ",
      "$  HH   H    HH    H      ",
      "###HH#######$##$###H######"
    ],
    "BROKEN UFO": [
      "@ @@@@@@@    &   @@@@@@@ @",
      "@S 0 $$$$S@@@S@@@S$$$$  S@",
      "@@@@@@@@@SSSHHHSSS@@@@@@@@",
      "          #  H  # --      ",
      "         X   H   H        ",
      "        #    H   HX       ",
      "        H    H   HH #--   ",
      "     - #H    H   H #  $-  ",
      "    # H#H    H   H    #   ",
      "   #$# # H   H   H  $#H#  ",
      "  # HH#$#H H###H H#$#   #$",
      " #   -$# ##H # H## #     X",
      "  H   #     H#H     #$ $H ",
      "  H#$#H     H#H      #$#H ",
      "  H #     H######H    X H ",
      "###H H###############H H##"
    ],
    "LAST SEQUENCE": [
      " #                      # ",
      "S# &  $$$$$         000 # ",
      "S#### ################### ",
      "S                         ",
      "####H H@@@#@@@#@@#@@#H####",
      "$ # H H@  #   #  # $#H#   ",
      "####H H@  #   #$ ####H #$ ",
      "    H H@  ###H#@H   ##H#  ",
      "###SH H @H#  H- @@#H$#H #H",
      "   SH H @H   # H H#####H##",
      "###SH H @###H##H  #   #H #",
      "$H# H H@  H#H ######H ##H ",
      "  # H H@ $ #H$#   $#H$ ##H",
      "####H H@@@@###$   #######H",
      "      H      ######      H",
      "############H      H######"
    ],
    "SIMPLE PASSAGE": [
      "& -----     -  - - - -    ",
      "##$   H##### H#$#$H$#$# $#",
      " ##$  H #### H@#@@@@@H H##",
      "  ##$ H $### H      #H-H-#",
      "  $## H ##$# H ###H#######",
      " $##  H $### H #$$#H      ",
      "$##   H ##$# H # H#H---H#$",
      "##$   H $### H ###########",
      " ###  H ##$  H# --- ---  0",
      " ##$  H #### H#H#  # $ #$#",
      "  ### H $### H#H # #######",
      "$ ##  H ##$# H# - S ------",
      "###   H ###  HSH #$#     H",
      " ##   H #$##H#SH ###$#   H",
      "$ ####H $###H#SH#  ###$##H",
      "######H ####H#SH#   $####H"
    ],
    "PLAIN SOLUTION": [
      "000 --------------- #####S",
      "   #  H     $     H #&   S",
      "###   H @   #   @ H ###H S",
      "  $    H@@@@X@@@@ H    H S",
      "  #   #H         H@@@@@@@S",
      "   ####H#H H H#HH        S",
      "       H#$#$#$#H  #######H",
      "$      H#######H ##     #H",
      "##   #HH #$$$# H # $#S# #H",
      "  #####H ##### H # ##S# #H",
      "       H ----- H # # S# #H",
      "       H#$$$$$#H # # S# #H",
      "       H@@@@@@@H  $#S # #H",
      "$    H#         ####S$# #H",
      "#   #H#               #  H",
      "##########################"
    ],
    "CHECKER MANAGEMENT": [
      "            -  0       0- ",
      "S  $ $     H #$#######$# H",
      " S # #@#@@@H# #$# # #$# #H",
      "  S#@#@#@@@H # #$# #$# # H",
      "   S$    & H# # #$#$# # #H",
      "  S # #@#@@H # #$# #$# # H",
      " S  #@#@#@@H# #$# # #$# #H",
      "S$         H #$# # # #$# H",
      "@@  ##H  @@H             H",
      " @@@@@@@   H-           -H",
      " - - -   @@H-H@###H###@H-H",
      "#$#$#$#H   H-     S     -H",
      "@H-H-H#H @@H-     S     -H",
      "@#####@H   H $    S    $ H",
      "-------H H#H# $   S   $ #H",
      "H        H#H#############H"
    ],
    "TRUST YOUR AGENT": [
      "          S               ",
      "$0   -$-   S $-----------$",
      "H-  -$H$-  S$H$- 0 $ 0 -$H",
      "H $-  H  -S  H  -$-$-$-  H",
      "H -   H  S-  H   - $ -   H",
      "H-    H S  - H  -$-$-$-  H",
      "H-   -H S   -H - - - - - H",
      "H -$- H S  - H- -$-$-$- -H",
      "   -  H  S-  H - - $ - - H",
      "  -$- H  -S  H  -$ $ $-  H",
      " -   -H -  S-H   - $ - - H",
      "------H------H    -$-   -H",
      "------H------H     -     H",
      "------H------H           H",
      "------H------H&  $ ------H",
      "######H############  $   $"
    ],
    "LONG WALL": [
      "                          ",
      "#########################S",
      "SSSSSSSSSSSSSSSSSSSSSSSSSS",
      "S######################## ",
      "S#  - - - ------ - - -  #H",
      "S#H# #$#$#SS$$SS#$#$#$#H#H",
      "S#H#H H H#      #--H-H#H#H",
      "S#H######@@@@@@@@######H#H",
      "S H      H         H     H",
      "H@#######H#@##@@###H#####H",
      "H@$###########$#$#####$##H",
      "H@##$#######$########$#$@H",
      "H@$########$#######$##$#@H",
      "H@##$###$############$#$@H",
      "H@#               &000  @H",
      "H   H#################H  H"
    ],
    "SCATTERED STAGES": [
      "   000                &   ",
      "   ###H   ##H   ##H  H### ",
      "$     H$    H$    H$ H    ",
      "##H    ##H   ##H  H##H    ",
      "  H      H     H     H    ",
      "   ###   H##   H##    ###H",
      "$      $     $     $     H",
      "##     ##    ##    ##    H",
      "                         H",
      "   ### $  ## $  ##   H### ",
      "$      ##    ##    $ H    ",
      "##                H##H    ",
      "                  H       ",
      "  H###H  H##H  H##H  H###H",
      "$ H   H$ H  H$ H  H$ H   H",
      "##H    ##   H##   H##    H"
    ],
    "ENEMY STORAGE": [
      "S@   @@@           @$     ",
      "S@@@ $$$00@@@@@@@@@@#####H",
      "SSSH @@@@@     HHHH      H",
      "  #H       ####    H --  H",
      "H#$H ######       #H# $#H ",
      "H### #- -   H#H  ##H####H ",
      "H#$  #$#$#H#H#H##$#H#H #H ",
      "H### @@@@HH#HS$@  #H#H   H",
      "H---  -- H #   @-----H # H",
      "   H H  # $@@@@@@@@@@@@@@H",
      "###H H  #### - - - - - - H",
      "$H#H H#    #  # H # #$#$#H",
      "  #H H#   $#H#$#H#$# # # H",
      "@@@@ @@@@@@@  # H X #$#$#H",
      "         0&     H        H",
      "##########################"
    ],
    "MOUSE": [
      " ####&              0#### ",
      "SH  ##              ##  HS",
      "SH##-##  H######H  #####HS",
      "SH #  # H#      #H # #$#HS",
      "SH #$ HH#        #HH $##HS",
      " H#$X-H#          #H ###H ",
      "H ###$#  -0-  -0-  #H ## H",
      " H ##X#   #    #   #### H ",
      "H     ##H#$#HH#$#H##     H",
      " H     #H #    # H#     H ",
      "H      ##H      H##      H",
      " H      #H      H#      H ",
      "H     $ ##H    H## $     H",
      " H   --- ##H  HX# ---   H ",
      "H      -- ## H#$ --      H",
      "H##############S#########H"
    ],
    "level-13": [
      "   ## ## ###    ### ## ## ",
      "  S##S##S### &0 ###S##S##S",
      "  S  S##S## H##H ##S##S  S",
      " S#0SS SS  H@  @H  SS SS0#",
      "SS##  S   H@ $$ @H   S  ##",
      "S##  S    H      H    S  #",
      "#   S    XH######HX    S  ",
      "   S    # H    H#H #    S ",
      "  S    # H#  ##  H  #    S",
      " S    #  HH ##@#H @$ #    ",
      "SS   # $# H ##$# H    #   ",
      "S S #   -H   @#  @H    # S",
      "  SX $H#  #H  $   H-@H  XS",
      " S# -#H-    @-@------H   #",
      "SS X   $H#S  $  S#$  H  X ",
      "S ########################"
    ]
}}