{
  "levels": {
    "name": "msx_chp",
    "total": 19,
    "PACIFIST MISSION": [
      "     ##          H  #####H",
      "H####-#$#########-H---#  H",
      "H#  #  -         H###$#  H",
      "H $####0#########0### # H#",
      "H#              # ###SSSH#",
      "H ##H#  ##H##H#H# ########",
      "H###H####H@@@@@H#    ##0 -",
      "  ##H# ###   H-H@@@@ ####H",
      "H#  H##H##  #H $#  #    #H",
      "H###H## ##H##H#-0     #H#H",
      "H#  ######H #H@ ###H ####H",
      "H#H###H0 #H# H      #### H",
      "H###### # H# H## #H &HHHH#",
      "H#  #  # #H #### #H###  H ",
      "H##H##H #  H     ##H#$# #H",
      "H #H ######H#######H # # H"
    ],
    "BALANCED FLOORS": [
      "  -                      &",
      " @ @@@@@@@@@H#@@@@@@@@@@@H",
      "           @H            H",
      " ##@@@@@@@@@@H@@@@@@@@@@ H",
      " #          @H  - -    @ H",
      " @H@@@@@@@@  H @ 0 @H  @ H",
      " @H - -    @  @@@@@@@@H@ H",
      " @H@ 0 @H  @ ---  - - H@@@",
      " @H@@@@@@@H@    H@ 0 @H @@",
      "  --  - - H@  H@@@@@@@@@ #",
      " @  H@ 0 @H@@@@  - -      ",
      " @H@@@@@@@      @ 0 @H H# ",
      " @H---------@@H@@@@@@@@H##",
      " @H           H@     - H  ",
      " @@@@@@@@@@@@@@@   H#$# #H",
      "                   H# ## H"
    ],
    "TURNING POINT": [
      "  - - -----H-------  -##  ",
      "H#0# #     H#########   #H",
      "H# ####### H###     # #H H",
      "H#  &    # ##     ### #$#H",
      "H## ##  -H ## @@@@ @@@@@##",
      "H   ##-$ # ## @  # #H--  #",
      "H #      # ## $#H# #H-####",
      "H#0##H#H # # -##H# #H- ##$",
      "H### H#H H- # # H  #H-####",
      "H#0#H #  # ## #H# # H#H#  ",
      "H # #  H-# ## #H   H###H- ",
      "H#0 #-#H## #-- H# #H#    H",
      "H #  #   #   # ##H#H#### H",
      "H     #  ###  H # #H#### H",
      "H # #H-# - #H H # #H#### H",
      "#H ### ### ########H   ###"
    ],
    "level-4": [
      " ### --   -- #0#0#0#H#H#HH",
      "H###H###-$$$H#######HHH#H#",
      "####H###-###H- - -H#H#H#HH",
      "H###H#     #H- - -H ######",
      "####H# ### #H- - -H#   ---",
      "####H# ### # - - -H## H## ",
      "### H# ### #H ### H ##H#$ ",
      "#0 #H# #$# #H# # #H## H## ",
      "### H#     #H## ##H# H#  #",
      "####H###   #H# # #H#H##  #",
      "#$# H####  #H ### H#H0# ##",
      "#--#H### # #H     H####  #",
      "### H##  # ##H###H###  #  ",
      "#& #H#$ # $##H   H #  #H# ",
      " #  H #####  H   H#  # H-#",
      " ############H###H ###H  #"
    ],
    "SWAN LAKE": [
      "H-----H------------H-----H",
      "H-----H ###  H ### H-----H",
      "0     0 # ## H # ##0     0",
      "   ##   ## # H ## #$###   ",
      "  ####   # $ H #   #####  ",
      " ######  #   H #  ####### ",
      " ####### $#  H# $####### H",
      "H ####### #  H# ####### H ",
      " H ##### ##  H## ##### H  ",
      "# H ### ##   H ## ### H # ",
      "&  -   -  - H        -  0 ",
      "# H ### ## H   ## ### H # ",
      " H ##### ##H  ## ###H# H  ",
      "H #H##### #H  # #### H# H ",
      " #H##### $#H  # $#### H# H",
      "$H#####  # H  ## H####$H#H"
    ],
    "level-6": [
      " ---- - -           ----- ",
      "HH---# ##      #0#0#     H",
      " H--#-# ##      #####  &H ",
      "#H-#-# ###        #### H #",
      "#H#-#-# ###      ###0#  H ",
      "#H-#-# #####      #####  H",
      " H#-#-# #####    ####     ",
      "HH #-# ####### ## ###    H",
      " H -#-# ########## ##   H ",
      "#H #-# ############    H #",
      "#H -#    ##########   H # ",
      "#H #      #########  H # #",
      " H         #######  H #   ",
      "#H    $     H H # --#H # #",
      " H   $$$    H#H#     #H   ",
      "#H  $$$$$   H#H         H#"
    ],
    "DIMETRODON": [
      " ---------& - - ---------0",
      "H########-H#$$###########H",
      "H#-------#H####H#---#----H",
      "H#------#H$#--#$H#--#----H",
      "H######-#H#----#H#--#----H",
      "H --- -##H#----#H##-#----H",
      "H#$-$#H#H$######$H#-#---$H",
      "H##$##H-H#------#H-$-H-###",
      "H#####$-H#------#H-##--# #",
      "#---H##HH#      #HH# #-# #",
      "#$ $ ##H         #H# -# $#",
      "#- -H# H   $ $ $ #H ## - #",
      "#  #H#HH   #####  HH#---# ",
      " #### H-## ########H###-#H",
      "      H ##H     $##H   ###",
      "$    #H###H     ###H H#  $"
    ],
    "CAMEL TRY": [
      "&   -   ----------------- ",
      "--H# H##--- ----------###H",
      "-H# H#            ###----H",
      "H# H#   ##   ##    $ #   H",
      "# H#   #### ####  ####   H",
      " H#   ###########  #-#  #H",
      "H #  ############# #   ##H",
      "#H# # ########### ##  ##HH",
      "#H# #$########### #  ##H H",
      " H#   ##########    # H  H",
      "H #   ## ### ###   # H   H",
      "#H # # #  #  ###  # H  H# ",
      "# H #  #     # # H #    #H",
      "0H#H #  #   #   # H ###H# ",
      "H ## #   #  #    # H0 0H##",
      "#H0#  #  H   #    #H######"
    ],
    "EAGLE": [
      "            &            S",
      "       -- ### --         S",
      "H@ ####  # ###  ##### @H S",
      "H@@@@@#  #####  #@@@@@@H S",
      "H@HHHHH# #$##  #HHHHHH@H S",
      "H@$    -   HH   -    $@H S",
      "H@H HHH#0##HH##0#HHH H@H S",
      "H@H HHH## #--# ##HHH H@H S",
      "H@    H# #-  -# #H    @H S",
      "H@HHHH# -#    #- #HHHH@H S",
      "H@HHH#   # ## #   #HHH@H S",
      "H@HH#    ######    #HH@H S",
      "H@HHH#   # ## #     #H@H S",
      "H@@@HH#  # $$ #      H@H S",
      "H  @@H    H$$H         H S",
      "#H       #H  H#       H# #"
    ],
    "SWIMMING TURTLE": [
      "H-------HHHHHHHHHHHH#  & #",
      "H     $ $      ## H # #H# ",
      "H##      ####   ##H #H# #$",
      "H###    ######  ##H # #H#$",
      "HH###  # #### # ##H #H# #H",
      "H H## ### ## ###      #H# ",
      "H  H######$$#### #$# H# #H",
      "H #HH 0   $$   0##### #H# ",
      "H  H######$$#### #$# H# #H",
      "H H## ### ## ###      #H# ",
      "HH###  # #### # ##H #H# #H",
      "H###    ######  ##H # #H#$",
      "H##      ####   ##H #H# #H",
      "H     $ $      ## H # #H#$",
      "H-------HHHHHHHHHHHH#   ##",
      "                          "
    ],
    "ELEPHANT DUNGEON": [
      "##         -----------    ",
      "# H-   - -   - -      H   ",
      " H  ### # # # # ####H-#   ",
      "H  ##### # # # ######H    ",
      "H ### # # # # # ######H   ",
      "H ###### # # # ########H- ",
      "H #-### # # # # ########H ",
      "H # ###  # # # #  &    # H",
      "H ###-- #    ### ##0#### H",
      "H##    #      #  H ### # H",
      "H # $  #H# #H# H $ ### # H",
      "H # #  #H###H#$# # $ # # H",
      "H #  #H    #H# #$### # # H",
      "H #00###H### H # # ### # H",
      " H ##$ - -   ###         H",
      "  H   #   #H  $####### # H"
    ],
    "CRAB": [
      " #-------   ##### ------# ",
      " #H      ###     #     H# ",
      " ######H#  $  ####H###### ",
      "H &   #H###   $  #H#     H",
      "H#### #H#        #H# ####H",
      "H#  # #H#  #  #  #H# #  #H",
      "H#  # #H# ###### #H# #  #H",
      "H#  # HH####  ####HH #  #H",
      "H#  #HH###  ##  ####H#  #H",
      "H 0 HH##### ## #####HH   H",
      " ##H####### ## #######H## ",
      " #HH###### #### ######HH# ",
      " #H # - ### ## ### -- #H# ",
      " #H #  H # #### # H  ##H# ",
      " #H #H              H# H# ",
      "##H  ####H      H####  H##"
    ],
    "level-13": [
      "                          ",
      " ####### HHHHHHHHH@@@@@@@@",
      "@####   HHHHHHHHH         ",
      " ###  ####@#@#@#@#@H      ",
      "H##  @#####@#H#@#@#@#H   H",
      "H#  @@## #@#HH@#@#@#@#H HH",
      "H  @@@#####HHH#@#@#@#@#HHH",
      "H @@@@@@##HHHH  0 0 0-HHHH",
      "H $$$$$$ HHHHH@#@#@#@ # HH",
      "H @@@@@# #HHHH#$HH  &  H#H",
      "H     @@@@@HHH## HH ## # #",
      "HH#         H    ###### # ",
      "#H ###########--------##  ",
      "  H----------########## # ",
      " #      ---H-----------$ #",
      "H#######    ----------- H#"
    ],
    "SMOKED SALMON": [
      "  ---  - -    --          ",
      "  $ $H# H#H###            ",
      "  S# # ###H## # ###       ",
      "H#S## ## #H# ####$###  #  ",
      "H######@##H### ########## ",
      "H@H      #H0### ##H$H$H$  ",
      "H@H -#  - #H#  ### H H H  ",
      "H@H-$#H# #&H# #  ########H",
      "H@H -# #H@H###     ----- H",
      "H@H- #H# @H #     H     H#",
      "H@H -#$#H@H  #     H   H##",
      "H@H- # H@@H####     H  ###",
      "H @H @@@  H ## #     H ###",
      " H @H    @H#  # #   H#H ##",
      "  H @H@@@ H##### # H###H #",
      " H       @H##           H#"
    ],
    "BUTTERFLY TRICK": [
      "#&###0#############0### #H",
      "#H#--SS- -H   H- -  --#H#H",
      "#H#H# #   H- -H   # #H#H#H",
      "#H-H## #H   H   H# ##H-H#H",
      "#H#### ####H H#### ####H#H",
      "#H## # #  H#H#H  # # ##H#H",
      "#H#  H ### #H# ### H  #H#H",
      " H  $#   ## H ##   #$  H H",
      "H # ##    ##H##    ## # H ",
      "H## ## #####H##### ## ##H ",
      "H##  # ## ##H## ## #  ##H ",
      "#H # H # ###H### # H # #H ",
      "#H## #  ### H ###  # ##H##",
      " H#  # #$#  H  #$# #  #H #",
      "#H ###     H#H      ## H##",
      "######## #H###H# #########"
    ],
    "PRAYING MANTIS": [
      "##### ----     -------    ",
      "## - H    ###         ###H",
      "##H   ### $#$ -   -   $#$H",
      "  H H #   - #    H - -  #H",
      "H   H      ##H   H- -   #H",
      "#H   H### # #H  H#      #H",
      "########### #H  H##     #H",
      "#####H## -  #H H#### # ##H",
      "#  - H -  H #H H### # ## H",
      " H@0&H 0@ H #H H## # ### H",
      "H @## ##  H ##H## # #### H",
      "0H@$-  #@@H###H# # ##### H",
      "####---###H####$# #####  H",
      "#   ####  #### #$####  H##",
      "#        --     ###  H####",
      "########   #H      H######"
    ],
    "CREEPING CREATURE": [
      "H---        ---           ",
      "H   ## - H#H  #H#######H #",
      "H# ####     ## H#       H ",
      "H---# ### ### #H##H######H",
      "H# #  ###### ##H# H   # #H",
      "H- $-   ### ###  ### H#- H",
      "H# #    ## ### H#  #H## ##",
      "H  $   ## #### H## #H  ###",
      "H# # ### ## # H  #H##H #  ",
      "H   ### ##   H# # H-  H #H",
      "H# #$# ##   H## 0#- #$H##H",
      "H ### ###--H##  #0-#$ H# H",
      "H ####$# ####    # #$ H# H",
      "H #####      &H #  ## ## H",
      "H# ### #$#$# H #0#  ###  H",
      "H           H #   #     H#"
    ],
    "MYSTERIOUS CHAMELEON": [
      "   &   S                  ",
      "  #0#SS  -------          ",
      " # #SS   HHHHHHH          ",
      "#  #S   H######HHH        ",
      "#S#SS  H##---H-H#HH       ",
      "#S#   H##-HHHH $ HH----- H",
      "#S#   H#-H      HH#     # ",
      "#S#  H#-H   H   H - ######",
      "#S#SH##H SSH HH H#  $    H",
      "#S####-H   H- # HH# -$  H ",
      "#SSS#-H  ###S  # H #  $H##",
      "  - #H--# - S   # H-#     ",
      "## H--H# H ##H##H#H H#    ",
      " H#  H #  #H HS  H# H-#-  ",
      "  HH# # #H# #  H  H#  H# -",
      " $  ###H#H ####H   H#H  # "
    ],
    "level-19": [
      "##X  &     $           $  ",
      "     H####-#-----------#-#",
      "####HH################H###",
      "####HH####- HHHHHHHHHHHHH-",
      "####HH####0#H####-####H##$",
      "####HH###$##H##-----##H##@",
      "$###HH##$#H$H##-###-##H###",
      "@$##HH#$##H#-##-# #-##H###",
      "#@$#HH-###H$H##-#-#-##HHHH",
      "HS$#HH#-####H-$-- --$-H###",
      "##-#HH######H##-- --##H###",
      "#-##HH      H##     ##-   ",
      "    HH      H####$####H   ",
      "    HH  H---H ## $ ## H -H",
      "    HH H-   H   #$#   H- -",
      " HHHH   H----------------H"
    ]
}}