{
  "levels": {
    "name": "pc100",
    "total": 3,
    "NEC": [
      " S    S   S    S   S    S ",
      " S    S   S    S   S    S ",
      " S$   S   S$  $S   S$  $S ",
      " HH$  H   HHHHHH   HHHHHH ",
      " H H  H   H        H    H ",
      " H H$ H   H   $    H      ",
      " H  H H   HHHHHH   H      ",
      " H  H H   H        H    $ ",
      " H  H$H   H $      H  $ H ",
      " H   HH 0 HHHHHH 0 HHHHHH ",
      "H########################H",
      "H-  &  ---               H",
      "H #####  H       $       H",
      "H $###$  H           0   H",
      "H #####  H# $ H##########H",
      "##########################"
    ],
    "SYSTEM SOFT": [
      "S                         ",
      "S $-$-$ $   $   $ 0  $ $ H",
      "### # #H### ###H###H## ##H",
      "#   # #H#    #  #  H# # #H",
      "###H###H###H #$ ###H# # #H",
      "$ #H # H  #H #  #  H#  $#H",
      "###H #$H###H #  ###H#   #H",
      "   H       H--     H     H",
      "$-##X  H####  ####  ##X##H",
      "  #$   H#$$#  #       X  H",
      "  ##X  H#$$#  ###$    X  H",
      "  0 X  H#$$#  #       X 0H",
      "  ##X  H####  #      $X$ H",
      "       H     $           H",
      " $     H        &        H",
      "@##@##@##@##@##@##@##@##@#"
    ],
    "PLAYGROUND": [
      "            SS           #",
      "-----H      SS  0 ###H---#",
      " ####H######SS#####HHH  $#",
      "---  HH     SS    HH##X###",
      "$ $ $  H@#@#@@#@#@H-------",
      "# # #  H  $    $  H$ $ $ $",
      "   0   H#@#@##@#@#H       ",
      " @@@@@H     $$     H@@@@@ ",
      "      H  #@@@@@@#  H      ",
      " $    H            H  0 $ ",
      "X####H@    0$$     @H####X",
      "     H @@@#####X@@@ H     ",
      "#####H#  $      $  #H#####",
      "##$##H####  &   ####H#   #",
      "#####H$   H####H   $H#  $#",
      "##########################"
    ]
  }}