{
  "levels": {
    "name": "/home/az/src/Infinner/src/jvmMain/temp/pcengine.raw",
    "total": 17,
    "LODE RUNNER LOGO": [
      "                          ",
      "              S           ",
      "      -      &S           ",
      "###### #######H###########",
      "###### #######H###########",
      "###### ####  HH -H# ######",
      "######$###$#$H #$H # #####",
      "##H### ### # H # H   #####",
      "##H### ### # H # H #######",
      "# $  # $  H H#H$ #H  H####",
      "# ##-###### #########H####",
      "# ##$#$# H- #H- ###$#H # #",
      "#   ## #$H # H # # # H  ##",
      "# H# # # H$#$H$#$H-  H ###",
      "# H# H # H # H #-H ##H-H##",
      "#$H# H#  H # H # #H $#$H##"
    ],
    "HEART AND SOUL": [
      "                         S",
      "                         S",
      " ------            ------S",
      "H      ###     S###       ",
      "H     # H #   S#  0#      ",
      "H    #H-  H# S#0-H  #     ",
      "H    #  H- 0@@ H  -H#     ",
      "H    #H-  H-$H  -H  #     ",
      "H     # H-  H$-H  -#      ",
      "H     #-  H-$H  -H #      ",
      "H      #H-  H$-H  #       ",
      "H       # H-$H  -#        ",
      "H        #  H$-H#         ",
      "H         # $H #          ",
      "H         &#H$#           ",
      "###########H##############"
    ],
    "STRAIGHT WAY": [
      "                          ",
      "S                         ",
      "S0$$$$$$$$$$$$$$$$$$$$$$$$",
      "@@@@@@@@@@@@@@@@@@@@@@@@@H",
      "                        HH",
      "$$ $$$$$$$$$$$$$$$$$$$$$$H",
      "H@#@@@@@@@@@@@@@@@@@@@@@@@",
      "HH                        ",
      "H0$$$$$$$$$$$$$$$$$$$$$$$$",
      "@@@@@@@@@@@@@@@@@@@@@@@@@H",
      "                        HH",
      "$$$$$$$$$$$$$$$$$$$$$$ $$H",
      "H@@@@@@@@@@@@@@@@@@@@@#@@@",
      "HH                        ",
      "H0$$$$$$$$ $$$$$$$$$$$$$$&",
      "@@@@@@@@@@#@@@@@@@@@@@@@@@"
    ],
    "CUNNING PLAN": [
      "@@@@         H        @@@@",
      "@@@@         H        @@@@",
      "@@@@         H        @@@@",
      "@@@@         H        @@@@",
      "@@@@         H        @@@@",
      "@@@@         H        @@@@",
      "@@@@         H        @@@@",
      "@@@@         H        @@@@",
      "@@@@         H        @@@@",
      "@@@@         S        @@@@",
      "@@@@ H@@@@@##H        @@@@",
      "@@@@ H $$$$$ H        @@@@",
      "@@@@ H#S   S#H        @@@@",
      "@@@@  #######H        @@@@",
      "@@@@         H        @@@@",
      "@@@@  #     &H   00000@@@@"
    ],
    "GUARD HANDLING PRACTICE": [
      "@@@@           S      @@@@",
      "@@@@           S      @@@@",
      "@@@@           S      @@@@",
      "@@@@           S      @@@@",
      "@@@@           S      @@@@",
      "@@@@           S      @@@@",
      "@@@@           S      @@@@",
      "@@@@           S      @@@@",
      "@@@@         ##H      @@@@",
      "@@@@      # #  H      @@@@",
      "@@@@      ## # H      @@@@",
      "@@@@H      $  #H      @@@@",
      "@@@@H      #   H      @@@@",
      "@@@@H     ##   H      @@@@",
      "@@@@H          H      @@@@",
      "@@@@H   0      H     &@@@@"
    ],
    "EASY": [
      "                        #H",
      "                        #H",
      "                        #H",
      "#########################H",
      "                         H",
      "###  #   ## # #          S",
      "#   # # #   # #   # #@@@#H",
      "#   # # #   # #  X##X    H",
      "### # #  #   #           H",
      "#   ###   #  #           H",
      "#   # #   #  #           H",
      "### # # ##   #           H",
      "                #-       H",
      "               ##        H",
      "             H $         H",
      "          0  H   &       H"
    ],
    "TOO MANY TRAPS": [
      "                        H ",
      "                        H ",
      "                        H ",
      "$---------- $- $- $ -$ -S ",
      "H$$$$$$$$$$$H$$H$$H$$H$$H$",
      "H$$H$$-$$-$$H$$H$$H-$H$$H$",
      "HX#HX#XX#XX#HXXHXXXXXHXXHX",
      "H$$H$$$$$$$$H$$H$$$-$H$$H$",
      "H$$H$$H$$-$$H$$H$$H$$H-$H$",
      "H#XH#XH#XX#XHXXHXXHXXXXXHX",
      "H$$H$$H$$$$$H$$H$$H$$ -$H$",
      "H$$H$$H$$H$$H$$H$$H$$H$$H$",
      "HX#HX#HX#HX#HXXHXXHXXHXXHX",
      "H$$H$$H$$H$$H$-H$-H$-H$-H$",
      "H$$H$$H$$H0$H0$$0$$0$$0&$$",
      "X##X##X#SS##S##S##S##S#H##"
    ],
    "level-8": [
      "               S          ",
      "               S          ",
      "              -S          ",
      "             H     -----  ",
      "       ----- H ###@       ",
      "  H###@      H    $       ",
      "  H   $      H    #     #H",
      "  H   #     #H@   ####### ",
      "  H   ####### -           ",
      "  H -----      H          ",
      "  H      @#### H   -----  ",
      "  H      $     H##@       ",
      "  H#     #     H  $       ",
      "   #######     H  #     #H",
      "               H  ####### ",
      "             #&H     00000"
    ],
    "level-9": [
      " 0#                      S",
      " #                       S",
      "            - -----------S",
      "             #           H",
      "            #$#          H",
      "           #$#$#         H",
      "          #$#$#$#        H",
      "         #$#$#$#$#       H",
      "        #$#$#$#$#$#      H",
      "       #$#$#$#$#$#$#     H",
      "      #$#$#$#$#$#$#$#    H",
      "     #$#$#$#$#$#$#$#$#   H",
      "    #$#$#$#$#$#$#$#$#$#  H",
      "   #$#$#$#$#$#$#$#$#$#$# H",
      "  ## # # # # # # # # # ##H",
      " ###       0   &         H"
    ],
    "ITOH": [
      "                          ",
      "S                         ",
      "S --   -          -       ",
      "##  H##0H##H---  0 H###   ",
      "##  H ##H ##  $### H$###  ",
      "##  H ##H ## ##### H      ",
      "##  H $#XH #####  H######$",
      "##  H  ## H####  H########",
      "##  H  $# H##    H##    ##",
      "##  H   #H## ----H#     ##",
      " ##  #H  H##H          ## ",
      " ##$##H H## H---   --  ## ",
      "  ### H H##$H   ##H  H### ",
      "  ### H H#########H H###  ",
      "   #  H H ######  H H##   ",
      "&     H H         H H    0"
    ],
    "KONAKAWA": [
      "                          ",
      "S                         ",
      "S              $         $",
      "#####H  ##H    ##H  H#####",
      "#####H$ ##H 0  #@H  H#####",
      "$  ##H######H#######H##$##",
      "   ##H######H#######H## ##",
      "   ##H-H##  H ##  ##H$  ##",
      "   ##  H##$ H ##$ ##H   ##",
      "   ## -H##  H ##  ##H   ##",
      "   ##H  ##  H$##  ##H   ##",
      "  $##H ##$  H##   ##H  ## ",
      "##X##H ##   H## ####H  ## ",
      "##X##H##    H##  ###H ##  ",
      "     H      H       H     ",
      "0   $H      H       H    &"
    ],
    "level-12": [
      "                          ",
      "                       S  ",
      "                       S  ",
      "                       S $",
      "   &                   H##",
      "-  H#####              H$#",
      "   H#####              H##",
      "   H##         -       H#$",
      "   H##$$    H##$#H $##$HX#",
      "   H#### ###H# #H#H#  #H  ",
      "   H####    H#$#H# #   H  ",
      "   H##$ H### #H#0# #$- HS-",
      "-  H##  H    #$#H# #0 #S  ",
      "   H#####    #H# #  ## S  ",
      "   H#####              S  ",
      "                       S  "
    ],
    "PRECISE OPERATION": [
      "                          ",
      "     S                    ",
      "     S                    ",
      "     S                    ",
      "     S $                  ",
      "0      ##@@@@@@@@@H       ",
      "@@@@@@@@          H       ",
      "                $ H       ",
      "         H@@@@@##        0",
      "         H      @@@@@@@@@@",
      "         H $              ",
      "0          ##@H           ",
      "@@@@@@@@@@@@  H           ",
      "&           $ H           ",
      "@@@@@@@@@@@##            0",
      "            @@@@@@@@@@@@@@"
    ],
    "level-14": [
      "#-                        ",
      "    S                     ",
      "    S                     ",
      "   &S  ###################",
      "####S  #                  ",
      "    S  #    ##  #$#H   ##H",
      " ## S  # ---$#  #$# H  $# ",
      " $# S  #H   #$  ### H  #$-",
      "H#$ S  #H   ##   -# H  ## ",
      " ## S  #H    -      H   - ",
      " -  S  #H## #  ## H#  ## #",
      "# H S  #H#$#$# #$H### #$ #",
      "$#H S# #H# # # #$H #  #$ #",
      "$#H S ##H# # # ##H--- ## #",
      "#-H S  #H--  --      H   #",
      "    S      00         000#"
    ],
    "RIE": [
      "                          ",
      "S                         ",
      "S               - -       ",
      "S######&-  ##$## H #####  ",
      "S#######SH #####H ####### ",
      "S########H  ### H#########",
      "S###   ###H  #$ H### $ ###",
      "S###$ H###H    -H#########",
      "S###HS ### H###  #########",
      "S########  H###  #########",
      "S######@$  H###  ### $    ",
      "S### #### -H###  #########",
      "S###  #### H###   ########",
      "S###   ### H###    #######",
      "S-----     H-------       ",
      "             0            "
    ],
    "KELLY": [
      "#                        #",
      "@                      S @",
      "#                      S #",
      "@                      S @",
      "#      ----------------S #",
      "@ #   #                H @",
      "# #  #        # X      H #",
      "@ #0#         # X #   #H @",
      "# ##      ##  # X #   #H #",
      "@ #$#    #0$# # X #   #H @",
      "# #  #   @@@@ # X  # # H #",
      "@ #   #  #$   # X   #$ H @",
      "# #    # $### $ $  #$  H #",
      "@        H    H   #    H @",
      "#                      H #",
      "@&                     H @"
    ],
    "OVERCOME": [
      "                          ",
      " S                        ",
      "  SS  S  S SSSS SSSS      ",
      " S  S-S--S-S  --S--S-     ",
      " S  H H  H HHH  H  H SSS  ",
      " S  H  SS  S    SSS       ",
      "  HH   SS  SSSS S  S      ",
      " H    ##   ##  #   # #### ",
      " H   #  # #$ # ## ## #    ",
      " H   #    #  # # #$# ###  ",
      " H   # $# #  # #   # #$   ",
      " H    ##   ##  #   # #### ",
      " H          $   0 0 0 0 0 ",
      "########H#######H#######H#",
      " &      H   $   H   $   H ",
      "##########################"
    ]
}}